11111111111111111111111111111
110010000000C1111111111111111
11000011111011111111111111111
11P0011E000001111111111111111
11111111111111111111111111111
11111111111111111111111111111
